npcname_JP.	温泉マニア
npcname_EN.	citizen
numflavor_passiveJP.	0
numflavor_passiveEN.	0
numflavor_angeredJP.	3
numflavor_angeredEN.	0
flavorangered_JP.0	「何をするんですか！」
flavorangered_JP.1	「野蛮人！」
flavorangered_JP.2	「私だって」
numflavor_deathJP.	7
numflavor_deathEN.	0
flavordeath_JP.0	「私は善良な市民だったのに」
flavordeath_JP.1	「くそめ」
flavordeath_JP.2	「まいった」
flavordeath_JP.3	「ぐえ」
flavordeath_JP.4	「嘘でしょ」
flavordeath_JP.5	「なぜなんだー」
flavordeath_JP.6	「何の冗談ですか」
numflavor_killJP.	2
numflavor_killEN.	0
flavorkill_JP.0	「市民パワー」
flavorkill_JP.1	「ぺっ」
numflavor_welcomeJP.	0
numflavor_welcomeEN.	0
