npcname_JP.	—V‚Ñl
npcname_EN.	ganmbler
numflavor_passiveJP.	5
numflavor_passiveEN.	0
flavorpassive_JP.0	u‚­‚»‚Á‚­‚»‚ÁIv
flavorpassive_JP.1	uØ‹à‚ª‘‚¦‚écv
flavorpassive_JP.2	u‚Ü‚¾‚¾I‚Ü‚¾‹à‚Íc‚Á‚Ä‚é‚¼Iv
flavorpassive_JP.3	u‰R‚¾c‚±‚ñ‚È‚Ì‚Á‚Äv
flavorpassive_JP.4	‚´‚íEEE‚´‚íEEE
flavorpassive_EN.0	"Eh, what's a little more debt?"
flavorpassive_EN.1	"Not yet! I still have some money left!"
flavorpassive_EN.2	"Are you sure? It feels like I've been cheated somehow"
flavorpassive_EN.3	You hear enthusiastic chatter and card shuffling.
numflavor_angeredJP.	3
numflavor_angeredEN.	3
flavorangered_JP.0	uƒOƒbƒhIv
flavorangered_JP.1	u“q‚¯‚é‚©H‚»‚¿‚ç‚ªŸ‚Â‚©‚±‚¿‚ç‚ªŸ‚Â‚©v
flavorangered_JP.2	u‚Ü‚³‚µ‚­–½‚ª‚¯‚¾‚Èv
flavorangered_EN.0	"Finally! Touché!"
flavorangered_EN.1	"Is that your bet? Does it win or does *THIS* win?"
flavorangered_EN.2	"That's just how life goes!"
numflavor_deathJP.	3
numflavor_deathEN.	4
flavordeath_JP.0	u•‰‚¯‚½A‚©cv
flavordeath_JP.1	u‚±‚ñ‚È‚ÌƒCƒ“ƒ`ƒL‚ÉŒˆ‚Ü‚Á‚Ä‚éIv
flavordeath_JP.2	uƒCƒJƒTƒ}‚µ‚½‚ÈIHv
flavordeath_EN.0	"I... lost..."
flavordeath_EN.1	"It's unfair."
flavordeath_EN.2	"You cheated! I'm sure! It's too strange otherwise!"
flavordeath_EN.3	"Are you crazy? That's no way to cheat!"
numflavor_killJP.	3
numflavor_killEN.	3
flavorkill_JP.0	uŸ‚Á‚½‚¼Iv
flavorkill_JP.1	u‰½‚ª‚µ‚½‚©‚Á‚½‚ñ‚¾Hv
flavorkill_JP.2	u‚à‚¤ˆêŸ•‰‚¾Iv
flavorkill_EN.0	"I won!"
flavorkill_EN.1	"Whatcha gonna do about it?"
flavorkill_EN.2	"Another match!"
numflavor_welcomeJP.	0
numflavor_welcomeEN.	0